 ,.--'`````'--., 
(\'-.,_____,.-'/)
 \\-.,_____,.-//
 ;\\         //|
 | \\  ___  // |
 |  '-[___]-'  |
 |             |
 |             |
 |             |
 `'-.,_____,.-''    jgs

